###############################
# S#           #  #           #
#  #  #  ####  #  ####  #  ####
#     #     #  #        #  #  #
#######  ####  #  #  #  #  #  #
#     #  #     #  #  #  #     #
#  #  #  ####  #  ####  #######
#  #     #           #     #  #
####  ##########  #######  #  #
#  #        #  #     #  #     #
#  ##########  #  ####  #######
#  #  #  #  #     #        #  #
#  #  #  #  #  #  #######  #  #
#     #        #  #           #
####  #  #  #  #######  #  #  #
#        #  #     #  #  #  #  #
#  #  #  #  ####  #  #  #######
#  #  #  #  #  #  #  #        #
#######  #  #  #  #  #  #######
#        #     #             E#
###############################